{
  "tiles" : [ [1, 1, 1, 1, 1, 1, 1, 1, 1 ],
              [1, 0, 1, 1, 1, 1, 1, 0, 1 ],
              [1, 1, 1, 1, 1, 1, 1, 1, 1 ],
              [1, 1, 1, 0, 1, 0, 1, 1, 1 ],
              [1, 1, 1, 1, 1, 1, 1, 1, 1 ],
              [1, 1, 1, 0, 1, 0, 1, 1, 1 ],
              [1, 1, 1, 1, 1, 1, 1, 1, 1 ],
              [1, 0, 1, 1, 1, 1, 1, 0, 1 ],
              [1, 1, 1, 1, 1, 1, 1, 1, 1 ] ],

  "targetScore" : 1500,
  "moves" : 10,
}
